110111111100110010000011000100011101010111011001111010011111100011111000001001000110101110
010111111011011011111100001111100001001000001000000001110010010011010111011001111110111111

110110111101000010011010101011010010001100101000100101000001000000000110010010010110111110
011111111010111110100011110101001111011011110110111010101101011010010100010111101111101111

101111111001011101010011111101011010101011100100101111110100110011100100111101110111111110
011101110110010000101011000010100100011011010000001110000000100100100000000110111101111111

111011011101000101000101010000010100101101101011011111010001010001000000001101100011111110
011111111011010111011101001101001100110101110110100110101000100010100110101100111011111111

101111011101111110010110010011000000001100000101100001111101100011011100110101000101110110
011110111100110000110010001001000010000101110001111001011110001101111010001111111111111111

101111111011011100111111001111110101011111001111100101111000100011001100111011000110111010
110110111000100000100000000000000101100001110000011100001010001011011011011011111110101111

111010111110101100010111000100000000010001000001000100010100110010001110000110110101111110
011111111001011011001101011101110110101111100100111010001101000011110000111111101111111111

101110111010010110000011000110111010111000001011100010100110100110001110111010110111111110
111011001010001000111001100011100110010010101100111010010111000001110000011011101111111111

101111001100110010000000111001101101001111010010101001111101010100011000010011100111111110
101111011011110010111010110011000110001001010011001000110010100100110110100101111110111111

111110111011000011100100100010001000001001010001100111001110100001101100111011000111111100
011111101010111110011010100010100000011110010111011000110100101011101011001101111011111111

